[ 
	[4,1,1,1,1,4],
	[2,2,3,1,0,0],
	[1,1,2,2,1,0],
	[2,1,2,2,1,4],
	[1,2,3,3,2,1],
	[4,1,1,1,1,4]
] 
