[ 
	[3,1,0,1,1,3],
	[4,1,1,3,1,0],
	[2,1,3,1,1,0],
	[2,1,0,3,1,4],
	[0,1,3,1,1,0],
	[2,1,1,1,1,1]
] 
