[ 
	[3,1,2,1,0,3],
	[2,2,1,2,2,0],
	[1,1,1,1,1,0],
	[1,0,1,1,1,4],
	[2,2,2,2,2,0],
	[1,2,1,1,4,4]
] 
