[ 
	[4,2,0,1,2,3],
	[1,4,0,1,4,0],
	[0,2,2,0,1,4],
	[0,4,0,0,4,1],
	[2,1,4,4,0,0],
	[4,0,2,2,1,4]
] 
