[ 
	[2,0,2,0,2,0],
	[0,2,0,2,0,2],
	[2,1,1,3,1,0],
	[3,3,3,3,3,3],
	[0,2,0,2,0,2],
	[2,1,2,1,2,1]
] 
