[ 
	[1,0,3,1,4,2],
	[3,4,1,2,3,4],
	[0,0,0,0,1,1],
	[1,0,0,0,0,1],
	[1,2,3,1,4,2],
	[2,3,1,2,3,4]
] 
